/**
 *
 * Hi!
 * 
 * Please enter the data using the format below:
 * <subdomain name>: <WEBSITE NAME>
 *
 */

aalfiann: aalfiann.github.io
adryzz: adryzz.github.io
aktindo: aktindo.github.io
anil: anilseervi.github.io
ash-hnry: ash-hnry.github.io
appls: appls2appls.github.io
ayush: iddev5.github.io
decc00n: decca-dev.github.io
didier: www.munezero.me
dendydharmawan: dendydharmawan.vercel.app
eagleanurag: eagleanurag.github.io
fivenine: fivenine01.github.io
focus: ffork.github.io
frans: thedev.netlify.app
goose: scalgoon.github.io
harshdev: harshhhdev.github.io
ibrahim: minidevz.github.io
jj: thebotlynoob.github.io
kai: kaidevs.github.io
kevin: thedev.netlify.app
piyush: officialpiyush.github.io
sazid: palstheintrovert.github.io
subtra3t: subtra3t.github.io
themoddedchicken: TheModdedChicken.github.io
trungbot: trungdo2309.github.io
ttw: dattw.github.io
wiktor: wiktorwojcik112.github.io
zh: zh.github.io
/* Add subdomain in alphabetical order */
